111111111111111
1C00000100000C1
100111011100001
10C000P0000C0E1
100111011100001
1C00000100000C1
111111111111111