111111111111111
1C000000C000001
101111101111C01
100000000001101
101101111100001
1C00P00000001E1
111101111110001
1000000C0000001
111111111111111