111111111111111
1CCCCCCCCCCCCC1
1CCCCCCCCCCCCC1
1CCCCC1CCCCCCC1
1CCCC1E1CCCCCC1
1CCCCCCCCCCCCC1
1CCCCCCCCCCCCC1
1CCCCCPCCCCCCC1
111111111111111